EA texture/reptile.xpm
NO texture/cpu.xpm
SO texture/star.xpm
WE texture/bob.xpm

C 55,25,2
F 45,55,65

1111111111
1000000001
1000000001
10001D1001
