EA texture/reptile.xpm
NO texture/cpu.xpm
SO texture/star.xpm
WE texture/bob.xpm

C 55,25,6
F 45,55,65

 1111111111111111111111111111
100000000000000000000000000001
 1111111111111111111111111111

1111111111111111111111111111
10000000000000000000000000001
1000000000000000000000000001
1111111111111111111111111111
1
1
1
11111111111111111111111111111111111111111111111111111111111111111111111111111111111111111111111111111111111111111111111111111111
100001000000000000000000000000000000000000000000000000000100000100010000000000000000000000000000000000000000000000000001000001
1000000000000000000000000000100000000000000000000000000000000000000010000000000000000000000000000000000000000000000000001000001
10001000000000000000000000000000000000010000000000001000000000001100001000000000000000000000000000000000000000000000000000100001
1000000000000000000010000000000000000000000000000000000000000000000010000000000000000000000000000000000000000000000000001000001
1000000000000000000000000000000000000000000000000000000100000000000010000000000000000000000000000000000000000000000000001000001
1000000000000000000000000000000000000000000000000000000000000001000010000000000000000000000000000000000000000000000000001000001
1000000000000000000000000000000100000000000000000000000010000000000010000000000000000000000000000000000000000000000000001000001
1000000000000000000000000000000000000001000000000000000000000000000010000000000000000000000000000000000000000000000000001000001
100000000100001000100000000000000000000000000000000000000000000100010000000000000000000000000000000000000000000000000001000001
1000000000000000000000000000000000000000000000000000100000000000000010000000000000000000000000000000000000000000000000001000001
1000000000000000000000000000000100000000000000000000000000000000100001000000000000000000000000000000000000000000000000000100001
100000000000000000000000000000000000000000000000000000000000000000010000000000000000000000000000000000000000000000000001000001
1000010000000000000000000000000000000000000000000000000000000000100001000000000000000000000000000000000000000000000000000100001
1000000000000000000000000000100000000000000000000000000000000000000010000000000000000000000000000000000000000000000000001000001
1000100000000000000000000000000000000001000000000000000000000000000010000000000000000000000000000000000000000000000000001000001
10000000000000000000100000000000000000001000000000000100000000001000010000000000000000000000000000000000000000000000000001000001
10000000000000000000000000000000000000010000000000000000000000001000010000000000000000000000000000000000000000000000000001000001
1000010000000000000000000000000000000000000000000000000001000001000100000000000000000000000000000000000000000000000000010000001
10000000000000000000000000001000000000000000000000000000000000000000100000000000000000000000000000000000000000000000000010000001
100010000000000000000000000000000000000100000000000010000000000011000010000000000000000000000000000000000000000000000000001000001
10000000000000000000100000000000000000000000000000000000000000001000010000000000000000000000000000000000000000000000000001000001
10000000000000000000000000000000000000000000000000000001000000001000010000000000000000000000000000000000000000000000000001000001
10000000000000000000000000000000000000000000000000000000000000011000010000000000000000000000000000000000000000000000000001000001
10000000000000000000000000000001000000000000000000000000100000001000010000000000000000000000000000000000000000000000000001000001
10000000000000000000000000000000000000010000000000000000000000001000010000000000000000000000000000000000000000000000000001000001
1000000001000010001000000000000000000000000000000000000000000001000010000000000000000000000000000000000000000000000000001000001
10000000000000000000000000000000000000000000000000001000000000001000010000000000000000000000000000000000000000000000000001000001
10000000000000000000000000000001000000000000000000000000000000001000010000000000000000000000000000000000000000000000000001000001
10000000000000000000000000000000000000000000000000000000000000001000010000000000000000000000000000000000000000000000000001000001
1000010000000000000000000000000000000000000000000000000000000000000010000000000000000000000000000000000000000000000000001000001
10000000000000000000000000001000000000000000000000000000000000001000010000000000000000000000000000000000000000000000000001000001
1000100000000000000000000000000000000001000000000000000000000000000100000000000000000000000000000000000000000000000000010000001
10000000000000000000100000000000000000001000000000000100000000001000010000000000000000000000000000000000000000000000000001000001
1000000000000000000000000000000000000001000000000000000000000000000010000000000000000000000000000000000000000000000000001000001
1000000000000000000000000000000100000000000000000000000000000000100001000000000000000000000000000000000000000000000000000000001
100000000001000001000000000000000000000000000000000000000000000100010000000000000000000000000000000000000000000000000001000001
1000000000000000000000000000000000000001000000000000000000000000000010000000000000000000000000000000000000000000000000001000001
10000000010000100010000000000000000000010000000000000000000000001000010000000000000000000000000000000000000000000000000001000001
100000000000000000000000000010000000000010000000000000100000000011000010000000000000000000000000000000000000000000000000001000001
1000000001000000001000000001000010000000000000000000000001000000011000010000000000000000000000000000000000000000000000000001000001
100000000101010000000000000010000000000000000000000000000000000011000010000000000000000000000000000000000000000000000000001000001
110000100000000000000000000000000000000000000000000000000010000000000000000000000000000000010000000000000000000000000000000000001
10000000000000000000000000000001000000000000000000000000000000001000010000000000000000000000000000000000000000000000000001000001
1000000000010000010000000000000000000000000000000000000000000001000010000000000000000000000000000000000000000000000000001000001
10000000000000000000000000000000000000010000000000000000000000001000010000000000000000000000000000000000000000000000000001000001
10000000010000100010000000000000000000010000000000000000000000001000010000000000000000000000000000000000000000000000000001000001
100000000000000000000000000010000000000010000000000000100000000011000010000000000000000000000000000000000000000000000000001000001
10000000010000000010000000010000100000000000000000000000010000001000010000000000000000000000000000000000000000000000000001000001
10000000010101000000000000001000000000000000000000000000000000001000010000000000000000000000000000000000000000000000000001000001
1000000000000000000000000000100000000000000000000000000000000000000010000000000000000000000000000000000000000000000000001000001
1000010000000000000000000000000000000000000000000000000001000000000010000000000000000000000000000000000000000000000000001000001
1000000000000000000000000000100000000000000000000000000000000000000010000000000000000000000000000000000000000000000000001000001
1000010000000000000000000000000000000000000000000000000001000001000010000000000000000000000000000000000000000000000000001000001
1000000000000000000000000000100000000000000000000000000000000000000010000000000000000000000000000000000000000000000000001000001
10001000000000000000000000000000000000010000000000001000000000001000010000000000000000000000000000000000000000000000000001000001
10000000000000000000100000000000000000000000000000000000000000001000010000000000000000000000000000000000000000000000000001000001
10000000000000000000000000000000000000000000000000000001000000001000010000000000000000000000000000000000000000000000000001000001
1000000000000000000000000000000000000000000000000000000000000001100N0010000000000000000000000000000000000000000000000000001000001
10000000000000000000000000000001000000000000000000000000100000001000010000000000000000000000000000000000000000000000000001000001
10000000000000000000000000000000000000010000000000000000000000001000010000000000000000000000000000000000000000000000000001000001
1000000001000010001000000000000000000000000000000000000000000001000010000000000000000000000000000000000000000000000000001000001
10000000000000000000000000000000000000000000000000001000000000001000010000000000000000000000000000000000000000000000000001000001
10000000000000000000000000000001000000000000000000000000000000001000010000000000000000000000000000000000000000000000000001000001
1000000000000000000000000000000000000000000000000000000000000000100010000000000000000000000000000000000000000000000000001000001
1000010000000000000000000000000000000000000000000000000000000000110000100000000000000000000000000000000000000000000000000010001
100000000000000000000000000010000000000000000000000000000000000000000000000000000000000000000000000000000000000000000001000001
100010000000000000000000000000000000000100000000000000000000000000000000000000000000000000000000000000000000000000000001000001
100000000000000000001000000000000000000010000000000001000000000000000000000000000000000000000000000000000000000000000001000001
1000000000000000000000000000000000000001000000000000000000000000000010000000000000000000000000000000000000000000000000001000001
100000000000000000000000000000010000000000000000000000000000000100010000000000000000000000000000000000000000000000000001000001
1000000000010000010000000000000000000000000000000000000000000000100010000000000000000000000000000000000000000000000000001000001
1000000000000000000000000000000000000001000000000000000000000000000010000000000000000000000000000000000000000000000000001000001
100000000100001000100000000000000000000100000000000000000000000000000000000000000000000000000000000000000000000000000001000001
1000000000000000000000000000100000000000100000000000001000000000100010000000000000000000000000000000000000000000000000001000001
10000000010000000010000000010000100000000000000000000000010000001100010000000000000000000000000000000000000000000000000001000001
1000000001010100000000000000100000000000000000000000000000000000100000000000000000000000000000000000000000000000000000001000001
1000000000000000000000000000100000000000000000000000000000000000100000000000000000000000000000000000000000000000000000001000001
10001000000000000000000000000000000000010000000000001000000000001000010000000000000000000000000000000000000000000000000001000001
1000000000000000000010000000000000000000000000000000000000000000000010000000000000000000000000000000000000000000000000001000001
100000000000000000000000000000000000000000000000000000010000000000000000000000000000000000000000000000000000000000000001000001
100000000000000000000000000000000000000000000000000000000000000100001000000000000000000000000000000000000000000000000000000001
1000000000000000000000000000000100000000000000000000000010000000100001000000000000000000000000000000000000000000000000000000001
100000000000000000000000000000000000000100000000000000000000000010000100000000000000000000000000000000000000000000000000000001
10000000010000100010000000000000000000000000000000000000000000010010000000000000000000000000000000000000000000000000001000001
100000000000000000000000000000000000000000000000000010000000000000001000000000000000000000000000000000000000000000000000000001
10000000000000000000000000000001000000000000000000000000000000000001000000000000000000000000000000000000000000000000000000001
100000000000000000000000000000000000000000000000000000000000000000001000000000000000000000000000000000000000000000000001000001
1000010000000000000000000000000000000000000000000000000000000000100001000000000000000000000000000000000000000000000000001000001
1000000000000000000000000000100000000000000000000000000000000000110000100000000000000000000000000000000000000000000000001000001
1000100000000000000000000000000000000001000000000000000000000000000010000000000000000000000000000000000000000000000000010000001
1000000000000000000010000000000000000000100000000000010000000000100001000000000000000000000000000000000000000000000000001000001
1000000000000000000000000000000000000001000000000000000000000000100001000000000000000000000000000000000000000000000000001000001
1000000000000000000000000000000100000000000000000000000000000000100001000000000000000000000000000000000000000000000000001000001
1000000000010000010000000000000000000000000000000000000000000001000010000000000000000000000000000000000000000000000000001000001
10000000000000000000000000000000000000010000000000000000000000001000010000000000000000000000000000000000000000000000000001000001
10000000010000100010000000000000000000010000000000000000000000001000010000000000000000000000000000000000000000000000000001000001
100000000000000000000000000010000000000010000000000000100000000011000010000000000000000000000000000000000000000000000000001000001
1000000001000000001000000001000010000000000000000000000001000000011000010000000000000000000000000000000000000000000000000001000001
100000000101010000000000000010000000000000000000000000000000000011000010000000000000000000000000000000000000000000000000001000001
100000000000000000000000000010000000000000000000000000000000000011000010000000000000000000000000000000000000000000000000001000001
111111111111111111111111111111111111111111111111111111111111111111111111111111111111111111111111111111111111111111111111111111111
