NO /NO.xpm
SO /SO.xpm
WE /WE.xpm
EA /EA.xpm

F 45,55,65
C 15,20,25

111111111111111111111111111111
1000010000000000000000000000001
100000000000000000000000000011
1000100000000000000000000001
10000000000000000000100000001
100000N0000000000000000000001
1000000000000000000000000001
1000000000000000000000000001
1000000000000000000000000001
1000000001000010001000000001
10000000000000000000000000001
1000000000000000000000000001
10000000010101000000000000001
10000000000000000000000000001
1111111111111111111111111111
