NO texture/neco_boom.xpm
SO texture/neco_cute.xpm
WE texture/neco_gun.xpm
EA texture/neco_wine.xpm

F 45,55,65
C 15,20,25

1111111111
1000000001
1000000001
10001D1001
1000000001
100000N001
111D111111
1000000001
1000000001
1111111111





